111111111111111111111111111111111111111111111111111111111111111111111111111111111111
100100101001010100101000010010C00100010000100100101000100010000010010100101000100101
10C00C101000010100001001010000010000010C00100100101000100000100010000100101000100101
1111100011110101001011110110111111111111000001C0001000100010111011010100001000110101
10000010100101010111100101000001001001000C110110100010110111100010000100101110100101
10001C1000C0010000101000010000010010010010100100101000100000111011100001111000100101
1111111010000101001011101111P1111011010000100000001000100010100010C00100000000101101
10000000111000010000000001000001001001101111111110111000011111111001010010100010C101
10010100100001011111111101C01C010111010010100010001000100010010010111111111110110101
110111111111111100010000010110000010010000100010001E00100010000010010100101010100101
100100010001000100000010010000010010000010110000000001100010010010010100000010100101
1001C0010000000100010010011101111111011011100010001000111000111110000101111000110101
1000001100C1000110111111110000001000010010111111101111100010C00011011100001010100101
10010001110111110000000001000000001001001010C101001010100011011110000100100010000101
11111100000000011011111111101111111111000010000000000010001000001C000111110111101101
1C001001000100010010000001000000C010011011111111111111110111111111101100100000100101
100000010111110100001010010010100010010000100010000001000100001010000100101000100101
100010000001000100101010000110111110111101100010001001000000100010000101100001110101
11111110111111111111111111001C000010010000100011101001000111110110010100000000100101
1000100C0100100100010010010010010010010111111010001000010100100010111111110111110101
10001000010C1001C0010010011010111010110010100000111001000100000000000100000000100101
110110111100000100000000010000010010010000100010001001000110101011110110111111101101
100000000111100000111011110010111C00011010111110111011110100101C10000100000000100101
11111011110000010C010000010010000000010010100000001001000111101010010111101111100101
100100010000010111011111111111111101110111100010001001000100001010010100000000100101
100100000100000100010010010000000000010010101111111111111111111111111111111111111101
101101111111011100C10010010C10010001010010100010000101010100010010000100001010000101
100100100100000110000011010111011101010000100010010101010100000010100100001010010101
100100000100100100011010010000010001010010100C10000001010111111010101111011010010101
1000001C01C011010C0100101111011100010101111110111011000101000000101C0000000011110101
111111110100000111110110010000011011010000100010000101010000010010110111011000000101
100C1000010010010010001001C0100100C101111011011000C1010001111110101001000C1010010101
10000001011011110010C0110110101100C10100101000100100C10101000100101111101111100C0101
100010010100000100000000010000C10001010000100010111111111100010010100010101011101101
1111111101111111111111111111111111111101111110100100100001100000101000101C1010000101
10C100000001000010000010001000001000010010100000000000100100010010110110000010000101
100000010001010C10010C0000100100100101000010001001001C100111111010100000101010010101
110110111100010011111010001001011000011110111111111011111100100010111111111110111101
100100010001010110000010111101000010110000100010100000000100000010100010010000000101
100111010111010000001010C00001101000010010100000000000010110110000100C10000100010001
100100010001010010001010001001001001010010100010100100010100100010100000010100010101
111111111111111111111111111111111111111111111111111111111111111111111111111111111111
