111111111111111111111
1E1000000010000010001
101110111010111010101
101000100010001010101
101011101111101010101
101000100000101000101
10101011111C101111101
101010001000101000101
101111101011111010101
100C00001000000P10001
111111111111111111111
